 


  *******    
  *     ***  
 **#***   *  
 * p #  # *  
 * oo* # **  
 **oo*   *   
  ********   

